20 7
0 18
XXXXXXXXXXXXXXXXXX X
X    X        XXXX X
X XXXX  XXXXXX  XX X
X XXXX XXXXXXXX XX X
X X          XX XX X
X XXXXXXXXXX XX    X
XXXXXXXXXXXXXXXXXXXX