14 7
0 5
XXXXX XXXXXXXX
XX    XXXXX  X
XX XXXXXXXXX X
XX  XXXXXX   X
XXX XXXXXXXX X
XXX          X
XXXXXXXXXXXXXX