20 6
0 18
XXXXXXXXXXXXXXXXXX X
X       XX   XXX X X
XXXX XXXXXXX     X X
X    XXXXXXX XXX X X
XXXX         XXX   X
XXXXXXXXXXXXXXXXXXXX