8 5
0 6
XXXXXX X
X XXXX X
X  XXX X
X      X
XXXXXXXX
