5 5
0 1
X XXX
X   X
XXX X
XXX X
XXX X