5 5
4 3
X XXX
X   X
XXX X
XXX X
XXX X