15 8
0 4
XXXX XXXXXXXXXX
XXXX       XXXX
XX  XX XXX XXXX
X    X   X   XX
XXX XXXXX XXXXX
X    X    XXX X
XXXX XXXXX XXXX
XXXXXXXXXXXXXXX